1111111111
1011000011
1000011111
1011111111
1000111111
1110111111
1110111111
1110111111
1110000001
1111111111